111111111111
1E00T0000001
1E1001010101
1P0C00000001
111111111111
